R 1080 720
NO ./textures/mosaic1.png
SO ./textures/mosaic3.png
WE ./textures/mosaic2.png
EA ./textures/stone.xpm

S ./textures/cactus.png
F 80,25,210
C 251,153,0

        1111111111111111111111111
        1000000000110000000000001
        1011000001110000200000001
        1001000000000000000000001
111111111011000001110000000000001
100000000011000001110111100111111
11110111111111011100000010001
11110111111111011101010010001
11000000110101011100000010001
10000000000000001100000010001
10000200000000001101010010001
11000001110101011111011000W0111
11110111 1110101 101111010001
11111111 1111111 111111111111